{
    "tiles": [
            {
                "image": "blank",
                "type": "blank"
            },
            {
                "image": "road",
                "type": "road"
            },
            {
                "image": "roadLeft",
                "type": "road"
            },
            {
                "image": "roadRight",
                "type": "road"
            },

            {
                "image": "beach2",
                "type": "offroad"
            }
        ],

    "chunk": [
        [
            [4,4,4,4,4,4,1,1,1,1,4,4,4,4,4,4],
            [4,4,4,4,4,4,4,1,1,1,1,4,4,4,4,4],
            [4,4,4,4,4,4,4,2,1,1,1,3,4,4,4,4],
            [4,4,4,4,4,4,4,2,1,1,1,3,4,4,4,4],
            [4,4,4,4,4,4,4,2,1,1,1,3,4,4,4,4],
            [4,4,4,4,4,4,4,2,1,1,1,3,4,4,4,4],
            [4,4,4,4,4,4,4,2,1,1,1,3,4,4,4,4],
            [4,4,4,4,4,4,4,2,1,1,1,3,4,4,4,4],
            [4,4,4,4,4,4,4,2,1,1,1,3,4,4,4,4],
            [4,4,4,4,4,4,4,2,1,1,1,3,4,4,4,4],
            [4,4,4,4,4,4,4,1,1,1,1,3,4,4,4,4],
            [4,4,4,4,4,4,2,1,1,1,1,4,4,4,4,4],
            [4,4,4,4,4,4,2,1,1,1,3,4,4,4,4,4],
            [4,4,4,4,4,4,1,1,1,1,4,4,4,4,4,4],
            [4,4,4,4,4,2,1,1,1,3,4,4,4,4,4,4],
            [4,4,4,4,4,2,1,1,1,3,4,4,4,4,4,4]
        ],
        [
            [4,4,4,4,4,2,1,1,1,3,4,4,4,4,4,4],
            [4,4,4,4,4,2,1,1,1,3,4,4,4,4,4,4],
            [4,4,4,4,4,2,1,1,1,3,4,4,4,4,4,4],
            [4,4,4,4,4,2,1,1,1,3,4,4,4,4,4,4],
            [4,4,4,4,4,2,1,1,1,3,4,4,4,4,4,4],
            [4,4,4,4,4,2,1,1,1,3,4,4,4,4,4,4],
            [4,4,4,4,4,2,1,1,1,3,4,4,4,4,4,4],
            [4,4,4,4,4,2,1,1,1,3,4,4,4,4,4,4],
            [4,4,4,4,4,2,1,1,1,3,4,4,4,4,4,4],
            [4,4,4,4,4,2,1,1,1,3,4,4,4,4,4,4],
            [4,4,4,4,4,2,1,1,1,3,4,4,4,4,4,4],
            [4,4,4,4,4,2,1,1,1,3,4,4,4,4,4,4],
            [4,4,4,4,4,2,1,1,1,3,4,4,4,4,4,4],
            [4,4,4,4,4,2,1,1,1,3,4,4,4,4,4,4],
            [4,4,4,4,4,2,1,1,1,3,4,4,4,4,4,4],
            [4,4,4,4,4,2,1,1,1,3,4,4,4,4,4,4]
        ]
    ],
    "level": [
        1,0,1,0,1,1,1,0,1,1,0,1,1,1,1,1,1,0,0,0,0,0,1,1,1,1,1,1,0,1,0,0,0,0,1,1,1,0,1,0,1,0,1
    ]
}